1111111111111111111
1E0C00000P000C00001
1111111111001111111
1000000000000000001
1000000000111110001
1000000000000000001
1111111100000000001
1000000000000000001
100000000P000C00001
1P00000000000000001
1111111111111111111