11111111111111111111111111111111111111111111111111111111111111111111111111111111111111111
100000000000000000E000000C000000000000000000000000000000000C000000000000000000000000000P1
11111111111111111111111111111111111111111111111111111111111111111111111111111111111111111