
111111111111111111111111111
100000000000000000000000001
100000000000000000000000001
10000000000000C00C000000001
100000000000000000000000001
100000P0000000E00E000E00001
100000000000000000000000001
10E000000000000000000000001
10000000000000000000E000001
1000000E0000000000000000001
100000000000000000000000001

111111111111111111111111111



111111111111111111111111111