1111111111
100CE000P1
1111111111