1111111111111
1001000000001
1C00011111001
1P001100EE001
1111111111111
